19
10
###################
o   T#$$    #   $ #
# ####      #   $ #
#   T#   $! #   $ #
#    #      ### $ #
#    #   ####   ! #
# $$   !    #$$   #
#####       #  ## #
#$   $$$$ T    ## #
#################_#