22
10
######################
o  $$# $$$$     $ #  _
#    #          $ # !#
#    #    ! #   $ #  #
#    #      ### $ #  #
#    ####   #     #  #
#    #$     #   ###  #
##   ###    #        #
#T   $$$$   #     #$$#
######################