19
13
###################
o    # $$$$     $ #
#    #          $ #
#    #    ! #   $ #
#    #      #   $ #
#    #      #     #
#    #      #     #
#           #     _
#    $$$$   #     #
#    ###########!##
#     # $$$$$     #
#T    # $$$$$     #
###################